7 8
########
#  #   #
#@$..$ #
# $.* ##
# $..$ #
#  #   #
########
