8 8
########
#.######
# .  ###
# $ $ ##
###   ##
#### @##
########
########
