8 8
########
####. ##
#  @  ##
# $$  ##
##. ####
##  ####
########
########
