8 8
########
########
###@ .##
###$ .##
### $###
##    ##
##    ##
########
