6 8
########
##.#  @#
#  #$  #
#   $. #
# .$   #
########
