11 6
######
#.. ##
#  $##
# $ .#
#  $ #
###@##
###$##
###  #
##  .#
##   #
######
