6 7
#######
# .$  #
#  $  #
#   ###
##. @##
#######
