10 5
#####
#  ##
#.  #
#  .#
##$ #
# $.#
#  $#
#@  #
#   #
#####
