8 8
########
###@.###
###$$###
###  ###
## $ ###
## ..###
##   ###
########

