8 8
########
####  ##
## $$ ##
# @   ##
#.  ####
#.  ####
########
########
